1111111
1P00001
1111101
1E0C001
1111111