1111111111
1000000101
1111111111