11111111111111111111111111
1P000000000C00000111000111
11111011100001111111100111
1E01011111110111100C001111
11110111100001110000000011
1C00000000000000001100C111
11111111111111111111111111
