1111111111111
1000P00101001
111000C001001
1111110000001
100C00C0E0101
1111111111111