11111111111111111111111111
1P000000000C00000111000111
11111011100001111111100111
1E00011111110111100C001111
11110111100001110000000011
1C00000000000000001100C111
11110001111111111111110011
11111100000011111100000011
10000000000C00000111000111
11110111100001111111100111
1C00011111110111100C001111
1111111C100001110000000011
1C00000000000000001100C111
11111111111111111111111111
