11111111111111111111111111
11100000000C0000011100P111
11111C11100001111111100111
1C00011111110111100C001111
11110111100001110000000011
1000000000000000001100C111
11110C011111E1111111110011
11111111111111111111111111