11111111
1E0010C1
11101101
1P0C0C01
11111111